0000000000000000
0000000002000000
0000000000000000
0000000222220000
0000000000000000
1111011111111111
1111001101001111
1111100100011111
0000000001000000
0000000000000000
1111111100011111
1111111100011111
