0000000000000220
0000220002000000
0000000000000000
0000000222220200
0000000000000000
1111011111111111
1111001101001111
1111100100011111
0000000001000000
0000000000000000
1111111100011111
1111111100011111
